{
    "__comment__0": "작성한 사람: 윤정도",
    "code": 10000,
    "area": [
        "111111111111111111111111111111111111111111111111111111111111111111111111111111111111111111",
        "111111111111111111111111111111111111111111111111111111111111111111111111111111111111111111",
        "111111111111111111111111111111111111111111111111111111111111111111111111111111111111111111",
        "111111111111111111111111111111111111111111111111111111111111111111111111111111111111111111",
        "111111111111111111111111111111111111111111111111111111111111111111111111111111111111111111",
        "111111111111111110000000000000000000000000111111111111111110000000000000000000000000011111",
        "111111111111100000000000000000000000000000000011111111110000000000000000000000000000000000",
        "000000000000000000000000000000000000000000000000000000000000000000000000000000000000000000",
        "000000000000000000000000000000000000000000000000000000000000000000000000000000000000000000",
        "000000000000000000000000000000000000000000000000000000000000000000000000000000000000000000",
        "000000000000000000000000000000000000000000000000000000000000000000000000000000000000000000",
        "000000000000000000000000000000000000000000000000000000000000000000000000000000000000000000",
        "000000000000000000000000000000000000000000000000000000000000000000000000000000000000000000",
        "000000000000000000000000000000000000000000000000000000000000000000000000000000000000000000",
        "000000000000000000000000000000000000000000000000000000000000000000000000000000000000000000",
        "000000000000000000000000000000000000000000000000000000000000000000000000000000000000000000",
        "000000000000000000000000000000000000000000000000000000000000000000000000000000000000000000",
        "000000000000000000000000000000000000000000000000000000000000000000000000000000000000000000",
        "000000000000000000000000000000000000000000000000000000000000000000000000000000000000000000",
        "000000000000000000000000000000000000000000000000000000000000000000000000000000000000000000",
        "000000000000000000000000000000000000000000000000000000000000000000000000000000000000000000",
        "000000000000000000000000000000000000000000000000000000000000000000000000000000000000000000",
        "000000000000000000000000000000000000000000000000000000000000000000000000000000000000000000",
        "000000000000000000000000000000000000000000000000000000000000000000000000000000000000000000",
        "000000000000000000000000000000000000000000000000000000000000000000000000000000000000000000",
        "000000000000000000000000000000000000000000000000000000000000000000000000000000000000000000",
        "000000000000000000000000000000000000000000000000000000000000000000000000000000000000000000",
        "000000000000000000000000000000000000000000000000000000000000000000000000000000000000000000",
        "000000000000000000000000000000000000000000000000000000000000000000000000000000000000000000",
        "000000000000000000000000000000000000000000000000000000000000000000000000000000000000000000",
        "000000000000000000000000000000000000000000000000000000000000000000000000000000000000000000",
        "000000000000000000000000000000000000000000000000000000000000000000000000000000000000000000",
        "000000000000000000000000000000000000000000000000000000000000000000000000000000000000000000",
        "000000000000000000000000000000000000000000000000000000000000000000000000000000000000000000",
        "000000000000000000000000000000000000000000000000000000000000000000000000000000000000000000"
    ]
}