{
    "__comment__0": "작성한 사람: 윤정도",
    "__comment__1": "맵 관련 정보",
    "__comment__2": "던전을 구성하는 맵과 마을을 구성하는 맵에 대한 정보들을 여기 작성한다.",

    "maps": [
        {
            "code": 1,
            "name": "test",
            "map_width": 2000.0,
            "map_height": 611.0,
            "area": [
                "0000000000000000000000000000000000000000000000000000000000000000000000000000000000000000000000000000",
                "0000000000000000000000000000000000000000000000000000000000000000000000000000000000000000000000000000",
                "0000000000000000000000000000000000000000000000000000000000000000000000000000000000000000000000000000",
                "0000000000000000001111111111111100000000000000000000000000000000000000000000000000000000000000000000",
                "0000000000000000001111111111111100000000000000000000000000000000000000000000000000000000000000000000",
                "0000000000000000001111111111111100000000000000000000000000000000000000000000000000000000000000000000",
                "0000000000000000001111111111111100000000000000000000000000000000000000000000000000000000000000000000",
                "0000000000000000001111111111111100000000000000000000000000000000000000000000000000000000000000000000",
                "0000000000000000001111111111111100000000000000000000000000000000000000000000000000000000000000000000",
                "0000000000000000001111111111111100000000000000000000000000000000000001000000100000000000000000000000",
                "0000000000000000001111111111111100000000000000000000000000000000000001000000100000000000000000000000",
                "0000000000000000001111111111111100000000000000000000000000000000000001000000100000000000000000000000",
                "0000000000000000001111111111111100000000000000000000000000000000000001000000100000000000000000000000",
                "1111000000000000000000000000000000000000000000000000000000000000000001000000100000000000000000000000",
                "1111000000000000000000000000000000000000000000000000000000000000000001000000000000000000000000000000",
                "1111000000000000000000000000000000000000000111111111111111111111000001000000000000000000000000000000",
                "1111000000000000000000000000000000000000000111111111111111111111000001111111111111111111000000000000",
                "1111000000000000000000000000000000000000000111111111111111111111000000000000000000000000000000000000",
                "1111000000000000000000000000000000000000000111111111111111111111000000000000000000000000000000000000",
                "1111000000000000000000000000000000000000000111111111111111111111000000000000000000000000000000000000",
                "1111000000000000000000000000000000000000000111111111111111111111000000000000000000000000000000000000",
                "1111000000000000000000000000000000000000000111111111111111111111000000000000000000000000000000000000",
                "1111000000000000000000000000000000000000000111111111111111111111000000000000000000000000000000000000",
                "0000000000000111111111111100000000000000000111111111111111111111000000000000000000000000000000000000",
                "0000000000000000000000000100000000000000000111111111111111111111000000000000000000000000000000000000",
                "0000000000000000000000000100000000000000000000000000000000000000000000000000000000000000000000000000",
                "0000000000000000000000000100000000000000000000000000000000000000000000000000000000000000000000000000",
                "0000000000000000000000000100000000000000000000000000000000000000000000000000000000000000000000000000",
                "0000000000000000000000000000000000000000000000000000000000000000000000000000000000000000000000000000",
                "0000000000000000000000000000000000000000000000000000000000000000000000000000000000000000000000000000"

            ]
            
        }
    ]

}