{
    "__comment__0": "작성한 사람: 윤정도",
    "__comment__1": "맵 관련 정보",
    "__comment__2": "던전을 구성하는 맵과 마을을 구성하는 맵에 대한 정보들을 여기 작성한다.",
    "__comment__3": "길이 2000, 높이 2000이상 금지 SGMapInfo.h에 타일 길이 하드코딩 해놈.",

    "map": [
        {
            "code": 1,
            "name": "test",
            "map_width": 1800,
            "map_height": 700,
            "area": [
                "111111111111111111111111111111111111111111111111111111111111111111111111111111111111111111",
                "111111111111111111111111111111111111111111111111111111111111111111111111111111111111111111",
                "111111111111111111111111111111111111111111111111111111111111111111111111111111111111111111",
                "111111111111111111111111111111111111111111111111111111111111111111111111111111111111111111",
                "111111111111111111111111111111111111111111111111111111111111111111111111111111111111111111",
                "111111111111111110000000000000000000000000111111111111111110000000000000000000000000011111",
                "111111111111100000000000000000000000000000000011111111110000000000000000000000000000000000",
                "000000000000000000000000000000000000000000000000000000000000000000000000000000000000000000",
                "000000000000000000000000000000000000000000000000000000000000000000000000000000000000000000",
                "000000000000000000000000000000000000000000000000000000000000000000000000000000000000000000",
                "000000000000000000000000000000000000000000000000000000000000000000000000000000000000000000",
                "000000000000000000000000000000000000000000000000000000000000000000000000000000000000000000",
                "000000000000000000000000000000000000000000000000000000000000000000000000000000000000000000",
                "000000000000000000000000000000000000000000000000000000000000000000000000000000000000000000",
                "000000000000000000000000000000000000000000000000000000000000000000000000000000000000000000",
                "000000000000000000000000000000000000000000000000000000000000000000000000000000000000000000",
                "000000000000000000000000000000000000000000000000000000000000000000000000000000000000000000",
                "000000000000000000000000000000000000000000000000000000000000000000000000000000000000000000",
                "000000000000000000000000000000000000000000000000000000000000000000000000000000000000000000",
                "000000000000000000000000000000000000000000000000000000000000000000000000000000000000000000",
                "000000000000000000000000000000000000000000000000000000000000000000000000000000000000000000",
                "000000000000000000000000000000000000000000000000000000000000000000000000000000000000000000",
                "000000000000000000000000000000000000000000000000000000000000000000000000000000000000000000",
                "000000000000000000000000000000000000000000000000000000000000000000000000000000000000000000",
                "000000000000000000000000000000000000000000000000000000000000000000000000000000000000000000",
                "000000000000000000000000000000000000000000000000000000000000000000000000000000000000000000",
                "000000000000000000000000000000000000000000000000000000000000000000000000000000000000000000",
                "000000000000000000000000000000000000000000000000000000000000000000000000000000000000000000",
                "000000000000000000000000000000000000000000000000000000000000000000000000000000000000000000",
                "000000000000000000000000000000000000000000000000000000000000000000000000000000000000000000",
                "000000000000000000000000000000000000000000000000000000000000000000000000000000000000000000",
                "000000000000000000000000000000000000000000000000000000000000000000000000000000000000000000",
                "000000000000000000000000000000000000000000000000000000000000000000000000000000000000000000",
                "000000000000000000000000000000000000000000000000000000000000000000000000000000000000000000",
                "000000000000000000000000000000000000000000000000000000000000000000000000000000000000000000"
            ],

            "npc": [

            ],

            "obstacle": [
                "1 30 30",
                "2 50 50",
                "3 70 78",
                "2 500 500",
                "4 300 300",
                "5 550 550",
                "6 100 300",
                "7 150 300",
                "9 200 600",
                "6 300 300",
                "7 350 300",
                "9 300 400",
                "6 400 300",
                "7 450 300",
                "9 400 500",
                "10 0 570",
                "10 200 530",
                "12 400 600",
                "12 600 600",
                "13 500 600",
                "12 700 600"
            ],

            "tile_width": 8,
            "tile_height": 3,
            "tile": [
                "1 2 4 3 1 2 4 3",
                "5 6 7 8 5 6 7 8",
                "5 6 7 8 5 6 7 8"
            ],

            "gravity": 900.0,
            "friction": 1500.0,
            "elasticity_down_time": 0.4,
            "elasticity_divided_force": 4.0
        }
    ]

}